1DTrajectory	-->Path
2DArea	-->Path
3DMedium	-->Path
Activity	-->Circumstance|(use this)Topic
Affector	NotDiscussed
Age	-->Characteristic
Attribute	-->Characteristic
ClockTimeCxn	-->Time
Comparison/Contrast	Removed
Contour	-->Path
Co-Participant	?-->Participant
Co-Patient	?-->Theme
Course	-->Path
Creator	-->Originator
DeicticTime	-->Interval
Destination	-->Goal
Donor/Speaker	-->Originator
Elements	NotDiscussed
EndState	Removed
Function	-->Purpose
InitialLocation	-->Source
Instance	?-->Identity
Location	-->Locus
Material	-->Source
Patient	-->Theme
Place	NotDiscussed
ProfessionalAspect	-->SocialRel
Reciprocation	-->Explanation
RelativeTime	-->Time
Scalar/Rank	Removed
StartState	Removed
State	Removed
Superset	NotDiscussed
Transit	-->Path
Traversed	-->Path
Undergoer	NotDiscussed
Value	Removed
ValueComparison	Removed
Via	-->Path
